21 21
31 31 31 31 31 31 31 31 31 31 31 31 31 31 31 31 31 31 31 31 31
31 69 69 69 69 69 69 69 69 69 68 69 69 69 69 69 69 69 69 69 31
31 69 67 67 67 67 67 67 67 67 67 67 67 67 67 67 67 67 67 69 31
31 69 67 67 67 67 67 67 67 67 67 67 67 67 67 67 67 67 67 69 31
31 69 67 67 67 67 67 67 67 67 67 67 67 67 67 67 67 67 67 69 31
31 69 67 67 67 67 67 67 67 67 67 67 67 67 67 67 67 67 67 69 31
31 69 67 67 67 67 67 67 67 67 67 67 67 67 67 67 67 67 67 69 31
31 69 67 67 67 67 67 67 67 67 67 67 67 67 67 67 67 67 67 69 31
31 69 67 67 67 62 88 67 67 67 67 67 67 67 88 61 67 67 67 69 31
31 69 67 67 67 67 67 67 67 67 67 67 67 67 67 67 67 67 67 69 31
31 69 67 67 67 67 67 67 67 67 67 67 67 67 67 67 67 67 67 69 31
31 69 67 67 67 67 67 67 67 67 67 67 67 67 67 67 67 67 67 69 31
31 69 67 67 67 67 67 67 67 67 67 67 67 67 67 67 67 67 67 69 31
31 69 67 67 67 67 67 67 67 67 67 67 67 67 67 67 67 67 67 69 31
31 69 67 67 67 67 67 67 67 67 67 67 67 67 67 67 67 67 67 69 31
31 69 67 67 67 60 88 67 67 67 67 67 67 67 88 88 67 67 67 69 31
31 69 67 67 67 67 67 67 67 67 67 67 67 67 67 67 67 67 67 69 31
31 69 67 67 67 67 67 67 67 67 67 67 67 67 67 67 67 67 67 69 31
31 69 67 67 67 67 67 67 67 67 67 67 67 67 67 67 67 67 67 69 31
31 69 69 69 69 69 69 69 69 69 69 69 69 69 69 69 69 69 69 69 31
31 31 31 31 31 31 31 31 31 31 31 31 31 31 31 31 31 31 31 31 31