21 21
11 11 11 11 11 11 11 11 11 11 11 11 11 11 11 11 11 11 11 11 11
11 69 69 69 69 69 69 69 69 69 68 69 69 69 69 69 69 69 69 69 11
11 69 67 67 67 67 67 67 67 67 67 67 67 67 67 67 67 67 67 69 11
11 69 67 67 67 67 67 67 67 67 67 67 67 67 67 67 67 67 67 69 11
11 69 67 67 67 67 67 67 67 67 67 67 67 67 67 67 67 67 67 69 11
11 69 67 67 67 67 67 67 67 67 67 67 67 67 67 67 67 67 67 69 11
11 69 67 67 67 67 67 67 67 67 67 67 67 67 67 67 67 67 67 69 11
11 69 67 67 67 67 67 67 67 67 67 67 67 67 67 67 67 67 67 69 11
11 69 67 67 67 62 88 67 67 67 67 67 67 67 88 61 67 67 67 69 11
11 69 67 67 67 67 67 67 67 67 67 67 67 67 67 67 67 67 67 69 11
11 69 67 67 67 67 67 67 67 67 67 67 67 67 67 67 67 67 67 69 11
11 69 67 67 67 67 67 67 67 67 67 67 67 67 67 67 67 67 67 69 11
11 69 67 67 67 67 67 67 67 67 67 67 67 67 67 67 67 67 67 69 11
11 69 67 67 67 67 67 67 67 67 67 67 67 67 67 67 67 67 67 69 11
11 69 67 67 67 67 67 67 67 67 67 67 67 67 67 67 67 67 67 69 11
11 69 67 67 67 67 67 67 67 88 88 88 67 67 67 67 67 67 67 69 11
11 69 67 67 67 67 67 67 67 67 67 67 67 67 67 67 67 67 67 69 11
11 69 67 67 67 67 67 67 67 67 67 67 67 67 67 67 67 67 67 69 11
11 69 67 67 67 67 67 67 67 67 67 67 67 67 67 67 67 67 67 69 11
11 69 69 69 69 69 69 69 69 69 69 69 69 69 69 69 69 69 69 69 11
11 11 11 11 11 11 11 11 11 11 11 11 11 11 11 11 11 11 11 11 11
