50 70
99 99 99 99 99 99 99 99 99 99 99 99 99 99 99 99 99 99 99 99 99 99 99 99 99 99 99 99 99 99 99 99 99 99 99 99 99 99 99 99 99 99 99 99 99 99 99 99 99 99
99 99 99 99 99 99 51 51 51 51 51 51 51 51 51 51 51 51 51 51 51 51 51 51 51 51 41 41 41 41 41 41 41 41 41 41 41 41 41 41 41 41 41 41 99 99 99 99 99 99
99 99 99 99 99 51 51 51 52 51 51 51 51 51 51 52 51 51 51 51 51 51 51 51 51 51 52 52 51 51 52 41 41 41 41 41 41 41 41 41 41 41 41 41 41 99 99 99 99 99
99 99 99 99 52 52 52 51 51 51 51 52 51 51 51 51 51 51 51 51 52 51 51 51 51 51 51 51 51 51 41 41 41 41 41 41 41 41 41 41 41 41 41 41 41 41 99 99 99 99
99 99 99 51 51 63 64 52 51 51 51 51 51 52 52 51 51 51 51 51 51 52 51 51 51 51 52 51 51 41 41 41 41 41 41 41 41 41 41 41 41 41 41 41 41 41 41 99 99 99
99 99 51 51 51 65 66 51 51 51 51 51 51 51 52 52 51 51 51 51 51 51 51 51 51 52 51 41 41 41 41 41 41 41 41 41 41 41 41 41 41 42 42 41 41 41 41 41 99 99
99 99 51 51 51 51 51 51 51 51 52 52 51 51 51 51 51 51 52 51 51 51 51 51 51 51 51 41 41 41 41 41 41 41 41 41 41 41 41 41 42 42 42 42 41 41 41 41 99 99
99 99 52 52 51 51 51 51 51 51 51 52 51 51 51 51 51 51 52 51 51 51 51 51 51 52 52 41 41 41 41 41 41 41 41 41 41 41 41 42 42 42 42 42 42 41 41 41 99 99
99 99 51 51 51 51 51 51 51 51 51 51 51 51 51 51 51 51 51 51 51 51 51 51 51 51 51 41 41 41 41 41 41 41 41 41 41 41 42 42 42 63 64 42 42 42 41 41 99 99
99 99 51 51 51 51 51 51 51 51 51 51 51 51 51 51 51 51 51 51 51 51 51 51 51 51 51 41 41 41 41 41 41 41 41 41 41 41 42 42 42 65 66 42 42 42 41 41 99 99
99 99 51 51 51 51 51 51 52 52 52 51 51 51 51 51 51 51 51 51 51 51 51 52 52 51 41 41 41 41 41 41 41 41 41 41 41 41 41 42 42 42 42 42 42 41 41 41 99 99
99 99 51 51 51 51 51 51 52 52 52 52 51 51 51 51 51 51 51 51 51 51 51 51 51 41 41 41 41 41 41 41 41 41 41 41 41 41 41 41 42 42 42 42 41 41 41 41 99 99
99 99 51 51 51 51 51 52 52 52 51 51 51 51 51 51 51 51 51 51 51 51 52 51 51 41 41 41 41 41 41 41 41 41 41 41 41 41 41 41 41 42 42 41 41 41 41 41 99 99
99 99 51 51 51 51 52 52 52 51 51 51 51 51 51 51 51 51 51 51 51 51 51 51 51 51 41 41 41 41 41 41 41 41 41 41 41 41 41 41 41 41 41 41 41 41 41 41 99 99
99 99 51 51 51 51 52 52 51 51 51 51 51 51 51 52 52 51 51 51 51 51 51 51 51 51 51 41 41 41 41 41 41 41 41 41 41 41 41 41 41 41 41 41 41 41 41 41 99 99
99 99 51 51 51 51 51 51 51 51 51 51 52 51 51 51 51 51 51 51 51 51 51 51 51 41 41 41 41 41 41 41 41 41 41 41 41 41 41 41 41 41 41 41 41 41 41 41 99 99
99 99 51 51 51 51 51 51 51 51 51 51 51 51 51 51 51 51 51 51 51 51 51 41 41 41 41 41 41 41 41 41 41 41 41 41 41 41 41 41 41 41 41 41 41 41 41 41 99 99
99 99 41 41 41 41 41 41 41 41 41 41 41 41 41 41 41 41 41 41 41 41 41 41 41 41 41 41 41 41 41 41 41 41 41 41 41 41 41 41 41 41 41 41 41 41 41 41 99 99
99 99 41 41 41 41 41 41 41 41 41 41 41 41 41 41 41 41 41 41 41 41 41 41 41 41 41 41 41 41 41 41 41 41 41 41 41 41 41 41 41 41 41 41 41 41 41 41 99 99
99 99 41 41 41 41 41 41 41 41 41 41 41 41 41 41 41 41 41 41 41 41 41 41 41 41 41 41 41 41 41 41 41 41 41 41 41 41 41 41 41 41 41 41 41 41 41 41 99 99
99 99 41 41 41 41 41 41 41 41 41 41 41 41 41 41 41 41 41 41 41 41 41 41 41 41 41 41 41 41 41 41 41 41 41 41 41 41 41 41 41 41 41 41 41 41 41 41 99 99
99 99 41 41 41 41 41 41 41 41 41 41 41 41 41 41 41 41 41 41 41 41 41 41 41 41 41 41 41 41 41 41 41 41 41 41 41 41 41 41 41 41 41 41 41 41 41 41 99 99
99 99 41 41 41 41 41 41 41 41 41 41 41 41 41 41 41 41 41 41 41 41 41 41 41 41 41 41 41 41 41 41 41 41 41 41 41 41 41 41 41 41 41 41 41 41 41 41 99 99
99 99 41 41 41 41 41 41 41 41 41 41 41 41 41 41 41 41 41 41 41 41 41 41 41 41 41 41 41 41 41 41 41 41 41 41 41 41 41 41 41 41 41 41 41 41 41 41 99 99
99 99 41 41 41 41 41 41 41 41 41 41 41 41 41 41 41 41 41 41 41 41 41 41 41 41 41 41 41 41 41 41 41 41 41 41 41 41 41 41 41 41 41 41 41 41 41 41 99 99
99 99 41 41 41 41 41 41 41 41 41 41 41 41 41 41 41 41 41 41 41 41 41 41 41 41 41 41 41 41 41 41 41 41 41 41 41 41 41 41 41 41 41 41 41 41 41 41 99 99
99 99 41 41 41 41 41 41 41 41 41 41 41 11 11 11 11 11 11 11 11 41 41 31 31 31 31 31 31 31 31 31 31 31 31 31 31 31 31 31 31 31 31 31 31 31 31 31 99 99
99 99 41 41 11 41 41 41 41 41 11 11 11 11 11 11 11 11 11 11 11 11 41 41 31 31 31 31 31 31 31 31 31 31 31 31 31 31 31 31 31 31 31 31 31 31 31 99 99 99
99 99 41 11 11 11 41 41 11 11 11 11 11 11 11 11 11 11 11 11 11 11 11 41 41 31 31 31 31 31 31 31 31 31 31 31 31 31 31 31 31 31 31 31 31 99 99 99 99 99
99 99 11 11 11 11 11 11 11 11 11 11 11 11 11 11 11 11 11 11 11 11 11 41 41 31 31 31 31 31 31 31 31 31 31 31 31 31 32 31 31 31 31 31 31 31 31 31 99 99
99 99 11 11 63 64 11 11 12 12 12 12 11 11 11 11 11 11 11 11 11 11 41 41 31 31 31 31 32 31 31 31 31 31 31 31 31 31 31 31 31 31 31 31 31 31 31 31 99 99
99 99 99 11 65 66 11 11 12 12 12 12 11 11 11 11 11 11 11 11 11 41 41 31 31 31 31 31 31 31 31 31 31 32 31 31 31 31 31 31 31 31 31 31 31 32 31 99 99 99
99 99 99 11 11 11 11 11 12 12 12 12 11 11 11 11 11 11 11 11 11 11 41 41 31 31 31 31 31 31 31 31 31 31 31 31 31 31 31 31 31 31 31 31 31 31 31 31 99 99
99 99 99 11 11 11 11 11 12 12 12 12 11 11 11 11 11 11 11 11 11 31 31 31 31 31 31 31 31 31 31 31 31 31 31 31 31 31 31 31 31 31 31 31 31 31 31 99 99 99
99 99 11 11 11 11 11 11 11 11 11 11 11 11 11 11 12 12 12 12 11 11 31 31 31 31 31 31 31 32 32 31 31 31 31 31 31 31 31 31 31 31 31 31 31 31 31 99 99 99
99 99 11 11 11 11 11 11 11 11 11 11 11 11 11 11 12 12 12 12 11 31 31 31 31 31 31 31 31 31 31 31 31 31 31 31 31 31 31 31 32 32 31 31 31 31 99 99 99 99
99 99 11 11 11 11 11 11 11 11 11 11 11 11 11 11 12 12 12 12 11 31 31 31 31 31 31 31 31 31 31 31 31 31 31 31 31 31 31 31 31 31 31 31 31 99 99 99 99 99
99 99 11 11 11 11 11 11 11 11 11 11 11 11 11 11 12 12 12 12 11 11 31 31 32 32 32 31 31 31 31 31 31 31 31 31 32 31 31 31 31 31 31 31 31 31 31 99 99 99
99 99 11 11 11 11 11 11 11 11 11 11 11 11 11 11 11 11 11 11 11 11 31 31 31 31 31 31 31 31 31 31 31 31 31 31 31 31 31 31 31 31 31 31 31 31 31 99 99 99
99 99 11 11 11 11 11 11 11 11 11 11 11 11 11 11 11 11 11 11 31 31 31 32 31 31 31 31 31 31 31 31 31 31 31 32 32 31 31 31 31 63 64 31 31 31 31 31 99 99
99 99 11 11 11 11 11 11 11 11 11 11 11 11 11 11 11 11 11 31 31 31 31 31 31 31 31 31 32 31 31 31 31 31 31 31 31 31 31 31 31 65 66 31 31 31 31 31 31 99
99 99 99 11 11 11 11 11 11 11 11 11 11 11 11 11 11 11 11 21 21 21 31 31 31 32 31 31 31 31 31 31 31 31 31 31 32 31 31 31 31 31 31 31 31 32 31 31 99 99
99 99 99 11 11 11 11 11 12 12 12 12 11 11 11 11 11 11 21 21 21 21 21 21 31 31 31 31 31 31 31 31 31 32 31 31 31 31 31 31 31 31 31 31 31 31 31 99 99 99
99 99 99 99 11 11 11 11 12 12 12 12 11 11 11 11 11 21 21 21 21 21 21 21 21 31 31 31 31 31 31 31 31 31 31 31 31 31 31 31 31 31 31 31 31 31 31 31 99 99
99 99 11 11 11 11 11 11 12 12 12 12 11 11 11 21 21 21 21 21 21 21 21 21 21 21 21 31 31 32 31 31 31 31 31 31 31 31 31 31 31 32 32 31 31 31 31 31 99 99
99 99 11 11 11 11 11 11 12 12 12 12 11 11 11 21 21 21 21 21 21 21 21 21 21 21 31 31 32 32 31 31 31 31 31 31 31 31 31 31 31 31 31 31 31 31 99 99 99 99
99 99 11 11 11 11 11 11 11 11 11 11 11 21 21 21 21 21 21 21 22 21 21 21 21 21 21 21 31 31 31 31 31 31 31 31 31 31 32 31 31 31 31 31 31 31 31 31 99 99
99 99 11 11 11 11 11 11 11 11 11 11 11 21 21 21 21 21 21 21 21 21 21 21 21 21 21 21 31 31 31 31 31 31 31 31 31 31 31 31 31 31 31 32 32 31 31 31 99 99
99 99 99 11 11 11 11 11 11 11 11 11 21 21 21 21 21 21 21 21 21 21 21 21 21 21 21 21 21 32 32 31 31 31 31 31 31 31 31 31 31 32 31 31 32 31 31 31 99 99
99 99 11 11 11 11 11 11 11 11 11 21 21 21 21 21 21 22 21 21 21 21 21 21 21 21 21 21 21 21 31 31 31 31 31 31 31 31 31 31 31 31 31 31 32 32 31 31 99 99
99 99 11 11 11 11 11 21 21 21 21 21 21 21 21 21 21 21 21 21 21 21 21 21 21 21 21 21 22 21 21 21 31 31 31 31 31 31 31 31 31 31 31 31 31 32 31 99 99 99
99 99 99 11 11 11 99 21 21 21 21 21 21 21 21 22 22 22 22 22 22 22 22 22 22 21 21 21 21 21 21 21 99 99 31 31 31 31 31 31 31 31 31 31 31 31 99 99 99 99
99 99 11 11 11 99 99 21 21 21 21 21 21 21 21 22 22 22 22 22 22 22 22 22 22 21 21 21 21 21 21 21 99 99 99 31 31 31 31 31 31 32 32 31 31 31 31 99 99 99
99 99 99 99 99 99 99 21 21 21 21 21 21 21 21 22 22 21 21 21 21 21 21 22 22 21 21 21 21 21 21 21 99 99 99 99 99 31 31 31 31 31 32 32 32 31 31 31 99 99
99 99 99 99 99 99 99 21 21 21 21 21 21 21 21 22 22 21 21 21 21 21 21 22 22 21 21 21 21 21 21 21 99 99 99 99 99 99 31 31 31 31 31 31 31 31 31 99 99 99
99 99 99 99 99 99 99 21 21 21 22 21 21 21 21 22 22 21 21 63 64 21 21 22 22 21 21 21 21 21 21 21 99 99 99 99 99 99 31 31 31 31 31 31 31 31 99 99 99 99
99 99 99 99 99 99 99 21 21 21 21 21 21 21 21 22 22 21 21 65 66 21 21 22 22 21 21 21 21 21 21 21 99 99 99 99 99 99 99 31 31 31 32 31 31 99 99 99 99 99
99 99 99 99 99 99 99 99 99 21 21 21 21 21 21 22 22 21 21 21 21 21 21 22 22 21 21 21 22 22 21 21 21 21 99 99 99 99 99 99 31 31 31 31 31 31 99 99 99 99
99 99 99 99 99 99 99 99 99 21 21 21 21 21 21 22 22 22 21 21 21 21 22 22 22 21 21 21 22 21 21 21 21 21 99 99 99 99 99 99 99 31 31 32 31 31 99 99 99 99
99 99 99 99 99 99 99 99 99 21 22 21 21 21 21 22 22 22 21 21 21 21 22 22 21 21 21 21 21 21 21 21 99 99 99 99 99 99 99 99 99 99 31 31 31 31 99 99 99 99
99 99 99 99 99 99 99 99 99 99 22 22 21 21 21 21 21 22 22 21 21 22 22 21 21 21 21 21 21 21 21 21 99 99 99 99 99 99 99 99 99 99 31 31 99 99 99 99 99 99
99 99 99 99 99 99 99 99 99 99 99 22 22 22 21 21 21 22 22 21 21 22 22 21 21 21 21 21 21 21 21 99 99 99 99 99 99 99 99 99 99 99 99 99 99 99 99 99 99 99
99 99 99 99 99 99 99 99 99 99 99 99 99 22 21 21 21 21 21 21 21 21 21 21 21 21 22 21 21 99 99 99 99 99 99 99 99 99 99 99 99 99 99 99 99 99 99 99 99 99
99 99 99 99 99 99 99 99 99 99 99 99 21 22 21 21 21 21 21 21 21 21 21 21 21 21 22 21 21 99 99 99 99 99 99 99 99 99 99 99 99 99 99 99 99 99 99 99 99 99
99 99 99 99 99 99 99 99 99 99 99 21 21 21 21 21 21 21 21 21 21 21 21 21 21 21 21 21 99 99 99 99 99 99 99 99 99 99 99 99 99 99 99 99 99 99 99 99 99 99
99 99 99 99 99 99 99 99 99 99 99 99 21 21 21 21 21 21 21 21 21 21 21 99 99 99 99 99 99 99 99 99 99 99 99 99 99 99 99 99 99 99 99 99 99 99 99 99 99 99
99 99 99 99 99 99 99 99 99 99 99 99 99 99 99 21 21 21 21 21 21 21 21 21 99 99 99 99 99 99 99 99 99 99 99 99 99 99 99 99 99 99 99 99 99 99 99 99 99 99
99 99 99 99 99 99 99 99 99 99 99 99 99 99 99 21 21 21 21 21 21 21 99 99 99 99 99 99 99 99 99 99 99 99 99 99 99 99 99 99 99 99 99 99 99 99 99 99 99 99
99 99 99 99 99 99 99 99 99 99 99 99 99 99 99 99 99 99 99 99 99 99 99 99 99 99 99 99 99 99 99 99 99 99 99 99 99 99 99 99 99 99 99 99 99 99 99 99 99 99
99 99 99 99 99 99 99 99 99 99 99 99 99 99 99 99 99 99 99 99 99 99 99 99 99 99 99 99 99 99 99 99 99 99 99 99 99 99 99 99 99 99 99 99 99 99 99 99 99 99